abandon : отказываться; оставлять; покидать; самовольно уходить
achieve : достигать; добиваться; достигать; добиваться
admit : признавать, допускать; давать право на вход
advertise : рекламировать; помещать объявление
affair: дела, занятия; любовная история
aim : цель, намерение; стремление, замысел
annual : ежегодный; годовой, годичный; ежегодник; однолетник
apart : в отдалении, в стороне, обособленно; (отложить) в сторону
apparent : явный, очевидный, несомненный; наглядный; видимый, (легко) различимый
appeal : воззвание, обращение, призыв; просьба, мольба; бжалование, жалоба; апелляция
appoint : назначать (на пост); утверждать (в должности); условливаться (о месте или времени)
appreciate : ценить, высоко ставить; быть признательным, благодарным; хорошо разбираться; дорожать
approval : одобрение, утверждение, санкция; визирование
arrange : систематизировать, классифицировать; договариваться, приходить к соглашению
arrive : прибывать, приезжать
assume : принимать, брать (на себя); присваивать; предполагать, допускать
attend : посещать, присутствовать; уделять внимание; заботиться
aware : сознательный, подготовленный
in behalf of : для; ради; в пользу; в защиту
benefit : преимущество, привилегия; польза; выгода
blame : порицание, упрёк; обвинять
boil : кипеть, бурлить; волнение; бешенство
bound : граница, предел; прыжок, скачок; обязанный, вынужденный
bowl : чашка; миска; таз; 
brake : тормоз
brief : краткое изложение; сводка, резюме
ceiling : потолок; максимум; предел; пик
chairman : председатель
challenge : испытание, проба (своих) сил; сомнение; вызов на дуэль;
charge : нагрузка, загрузка; цена, плата
charity : милостыня, подаяние; благотворительность; филантропия; благотворительное общество;
chew : жевать, пережёвывать; разжёвывать
circumstance : обстоятельства, условия, положение дел
claim : требование; претензия, притязание; требовать
clause : статья, пункт, условие; оговорка; разделить на статьи
cloth : ткань; сукно; ветошь; 
coal :  уголь
collar : воротник, воротничок; ошейник
commit : передавать; поручать, вверять; совершать (чаще дурное)
compete : состязаться, соревноваться, участвовать в соревновании
complain : жаловаться; выражать недовольство
compulsory : обязательный (для всех); принудительный, связанный с принуждением
conclude : прийти к заключению, (с)делать вывод; заканчивать, завершать
condemn : осуждать, порицать; браковать; конфисковать
conduct : ведение, руководство; вести, сопровождать; водить
confident : уверенный; самоуверенный, самонадеянный
confirm : подтверждать; утверждать; подкреплять, поддерживать
conscious : сознание; сознательная психическая деятельность
consequence : следствие; последствие; результат
consistent : совместимый, сообразный, согласующийся; твёрдый, плотный
consonant : согласный звук; совместимый, сообразный, согласный
consumer : потребитель; клиент; заказчик; покупатель; абонент; подписчик
contemporary : современник; ровесник, сверстник
contribute : делать вклад (в науку и т. п.); способствовать, содействовать
controversial : спорный, дискуссионный; любящий спорить, несговорчивый
convenient : удобный, подходящий; находящийся поблизости, под рукой
convey : перевозить, транспортировать; сообщать; передавать
convict : осуждённый; заключённый; заставить осознать свою вину
cope : управляться; находить время и силы; крыть, покрывать; покров
crew : судовая команда; экипаж
crowd : толпа;  толпиться, тесниться
crucial : решающий; ключевой; критический
curriculum : расписание; курс обучения; учебный план
damp : сырость, влажность; смачивать, увлажнять; уныние, подавленное настроение
depth : глубина, глубь
decline : падение, упадок, спад; наклоняться; клониться; отказываться
defeat : поражение; разгром; наносить поражение, разбивать
deliberate : преднамеренный, (пред)умышленный; нарочитый; размышлять; обдумывать, взвешивать
deliver : передавать, вручать; разносить, доставлять
demand : требование, настойчивая просьба; запросы
deputy : представитель; заместитель, помощник; депутат
deserve : заслуживать, быть достойным
desperate : отчаянный; доведённый до отчаяния; безрассудный
despite : вопреки, несмотря на
determination : решимость; решительность; определение, установление
dairy : маслодельня, маслобойня; сыроварня
distinction : разница, отличие, различие; распознавание; разграничение
distinguish : отличать, различать; разглядеть; отделять
due : должное; то что причитается; подлежащий выплате
elbow : локоть; подлокотник
embrace : объятие; обнимать, заключать в объятия, прижимать к груди
emerge : появляться, показываться; выясняться; выявляться
emergency : чрезвычайные обстоятельства, критическое положение; аварийная ситуация
entire : полный, целый, весь
entrance : вход; входная дверь; въездные ворота
estate : поместье, имение;  имущество, состояние; участок, площадка
estimate : оценка; смета, калькуляция; исчисление; предварительный подсчёт
eventually : в конечном счёте, в итоге, в конце концов
evidence : доказательство, свидетельство; очевидность, явность; улика
excited : оживлённый; деятельный; возбуждённый, взволнованный
executive : исполнительная власть; руководитель; роскошный
expense : расход; трата
exploit : подвиг; эксплуатировать
extent : протяжение, протяжённость; размер, величина
facility : лёгкость, несложность; способность; подвижность, гибкость (ума)
faith : вера, доверие
fascinating : очаровательный, обворожительный, пленительный
firm : твёрдый, непоколебимый, нерушимый; верный (своим убеждениям)
fold : складывать, сгибать; загибать; овчарня; загон для овец
former : прежний, бывший; предшествующий; прошедший; давний
fridge : холодильник
fry : жарить; жареное мясо; жаркое; мелкая рыбёшка
fuel : топливо, горючее
gap : интервал, промежуток; расстояние
genuine : подлинный, истинный, настоящий; искренний
gradually : постепенно, последовательно; мало-помалу, понемногу
guilty : виновный
highlight : световой эффект; световой блик; основной момент, факт
hire : нанимать; снимать, брать напрокат
impact : удар, толчок, импульс; влияние, воздействие; последствия
imply : подразумевать, предполагать; означать
impose : облагать (налогом, пошлиной и т. п.); налагать; возлагать
impress : отпечаток, оттиск; производить впечатление, поражать
incentive : побудительный, стимулирующий; вдохновляющий
insist : настаивать, настоятельно требовать, добиваться (чего-л.)
insurance : страхование; средство защиты; гарантия
intense : сильный; глубокий, значительный;  напряжённый, интенсивный
intent : поглощённый; полный решимости; настойчиво стремящийся
involve :  вовлекать, втягивать, впутывать, вмешивать; включать, содержать
justify : оправдывать, находить оправдание; подтверждать
keen : сильный, острый; обострённый; живо интересующийся, страстно увлекающийся
labour : труд; рабочий класс
lane : дорожка, тропинка; дорога с односторонним движением
lid : крышка, колпак; веко
margin : край, грань; кайма; запас; делать заметки на полях
mild : умеренный; спокойный, нерезкий, мягкий
modest : скромный, застенчивый; благопристойный
mood : расположение духа, настроение
narrow : узкий; тесный; ограниченный
neat : чистый, чистоплотный; опрятный, аккуратный
negotiate : договориться; получить (в результате переговоров); преодолевать (препятствия)
notion : понятие, представление; фантазия, заблуждение; мнение;
noun : существительное
obey : слушаться, повиноваться, подчиняться
oblige : обязывать; заставлять; делать одолжение
obtain : получать, доставать, приобретать; добиваться; быть признанным
opportunity : удобный случай; возможность, перспектива
origin :  источник; происхождение; начало координат
outcome : результат, последствие, исход; выход
outline : контур, обвод, абрис, очертание; набросок; эскиз
oven : печь; духовка
overcome : побороть, победить; превозмочь; охватить, обуять (о чувствах)
overwhelming : несметный; огромный; подавляющий; непреодолимый
owe : быть должным, задолжать; иметь моральный долг; испытывать какое-л. чувство
pace : походка, поступь, шаг; скорость, темп; длина шага
pan : кастрюля; таз; сковорода; противень
particular : частность, подробность, деталь
pavement : тротуар; дорожное покрытие
perceive : понимать, осознавать; постигать; различать, ощущать, чувствовать
persuade : убеждать; склонять, уговаривать; вдавливать, втискивать
pile : куча, пачка, связка; свая; столб
pin : булавка, брошка
pitch : бросок; похвала; реклама; смола
possess : обладать, владеть; захватывать (о чувстве, настроении и т. п.)
pot : горшок; котелок; (высокая) кастрюля
pour : лить; литься; поток
powder : порошок; толочь, превращать в порошок
proceed : продолжать (путь), идти далее
proposal : предложение; проект, план; внесение предложения
reckon : считать (особ. в уме), подсчитывать
regard : внимание, забота; уважение, расположение
regret : сожаление; раскаяние
relevant : уместный, относящийся к делу; актуальный
reliable : надёжный; достоверный
reluctant : вынужденный, неохотный; сопротивляющийся, с трудом поддающийся
rely :  полагаться, надеяться; доверять; зависеть (от чего-л.)
remedy : лекарство; лечебное средство; средство, мера (против чего-л.)
restrict : ограничивать; держать в определённых пределах; сводить к чему-л.
retire :   удаляться, уходить; ложиться спать; уходить в отставку
reveal : разоблачение; обнаружение; откровение
reward : награда, вознаграждение
rid : освобождать, избавлять; очищать
rival : соперник, конкурент
rub : тереть; протирать
rural : сельский, деревенский
shallow :  мелкий, мелководный; неглубокий; поверхностный, ограниченный; пустой
shortage : нехватка, недостаток; дефицит; недостача
significant : знаменательный, важный; существенный
slip : скользить; плавно или быстро передвигаться; вкрадываться
slope : уклон; покатость; наклон; склон, скат, откос
smash : столкновение; грохот, стук при падении, столкновении
spare : запасной, резервный; дополнительный
species : род, порода; вид, разновидность
squeeze : сжатие, сжимание; пожатие
stake: подпорка (для дерева); столб; ставка (в картах и т. п.)
stare : пристальный взгляд
steady : прочный, твёрдый, устойчивый; опора, держатель; 
steam : пар; паровой; энергия
steep : круча, крутизна; обрыв; вымачивать, замачивать
steer : направлять, руководить; управлять рулём; слушаться руля
stiff : жёсткий, крепкий; тугой, неэластичный
stir : шевеление, движение; суета, переполох; 
strict : точный, определённый, строгий, не допускающий отклонений
struggle : борьба; напряжение, усилие
substantial : прочный, крепкий; солидный; существенный, важный
sufficient : достаточный
survey : обзор; обозрение, осмотр
swallow : глоток; проглатывать
tackle : принадлежности, инструмент; хватать; останавливать
tape : лента; магнитофонная запись
tension : напряжение; напряжённость
thorough : тщательный, основательный, доскональный, детальный
threat : угроза
throughout : повсюду, везде; полностью; всё время
tidy : опрятный, аккуратный; чистый; прибираться; ставить на место
tight : туго завязанный, тугой; крепкий
tip : верхушка, кончик; оконечность
tough : жёсткий; плотный, упругий;  грубый, крутой; хулиган
towel : полотенце
track : путь, дорога; след; образ жизни
trade : ремесло, профессия; торговля; отрасль торговли
transfer : перенос, перенесение; перемещение
trap : западня, ловушка;  капкан
truck : тележка, вагонетка; грузовой автомобиль
tyre : шина, покрышка
unfair : несправедливый; недобросовестный
urge : понуждать, гнать, подгонять
urgent :  срочный, неотложный; крайне необходимый
van : фургон; товарный вагон; крытая повозка
virtue : добродетель, нравственность; эффективность; целомудрие
vital : жизненно важный; насущный;  энергичный, полный жизни
voluntary : добровольный; добровольная работа
vote : голосование, баллотировка; право голоса
wages : заработная плата
wipe : вытирать, обтирать, утирать
withdraw : забирать, брать назад; отнимать, отдёргивать
worth : ценность, значение; достоинство
wrap : окутывать, укутывать; плед, одеяло; шаль 
