wholesome   : полезный, здоровый
winged      : крылатый; летающий
eliminate   : устранять, исключать
dispense    : распределять; раздавать
solely      : единственно, только, исключительно
aspire      : стремиться
retain      : сохранять, удерживать
rusty       : ржавый
stove       : печка
garret      : чердак
cellar      : подвал
arise       : возникать, появляться
broad       : широкий, широкая часть
sweep       : пространство, круг, охват
edge        : остриё, лезвие; острота
dull        : унылый, тусклый, неяркий
sparkle : искорка; проблеск
gaunt : сухопарый; костлявый; исхудалый, измождённый
orphan : сирота
startle : испугать, напугать, встревожить
scream : пронзительный крик, вопль, визг
rough : грубый; неотделанный; необработанный, неочищенный
stern : суровый, твёрдый, непреклонный
twinkle: моргать; мигать; подмигивать
wail : завывание; вой
ripple : рябь
stock : скот, поголовье скота; запас, фонд
shed : навес, сарай
glance: быстрый взгляд; скользящий удар
shriek: скрип, скрежет, визг
whirl: вертеть(ся), кружить; вращать
howl: выть, завывать
resolve: решение, решать, принимать решение
calm: спокойствие, невозмутимость, тишина, покой
sway: качание, колебание; раскачивание
in spite of: несмотря на; вопреки
jar: сотрясение, дрожание, дребезжание
whine: ныть, хныкать; скулить, плакаться
dismally: печально, уныло; угрюмо
heel: пятка, каблук
sward: газон, дерн
stately: величественный, величавый; полный достоинства
luscious: сочный и сладкий; ароматный
rarely: редко, нечасто, изредка
gorgeous: яркий; великолепный, блестящий, превосходный
plumage: оперение; перья
flutter: трепетать, дрожать; колыхаться, развеваться
rush: бросаться, кидаться, устремляться; мчаться; нестись
grateful: благодарный; признательный; приятный
brim: край (сосуда), поле (шляпы), наполняться до краёв
gown:  платье; рабочий халат; мантия
pleat: складка; закладывать, делать складки
glisten: блестеть, сверкать; искриться; сиять
wrinkle: морщина; складка
farther: более отдалённый; дальнейший; позднейший; дальше, далее
innocent: невинный, чистый; непорочный; законный
expect: ожидать, ждать; рассчитывать, надеяться
dismay: смятение, тревога; испуг
inquire: спрашивать, узнавать
swift: быстрый, скорый; катушка, барабан; стриж
dwell: обитать, жить; жительствовать; пребывать; задерживаться
mention: упоминание; упоминать, ссылаться на
sink: понижать; ослабевать, угасать; утопать
chalk: мел; чертить мелом
plead: выступать в суде; ризывать; просить
dare: сметь, отваживаться; иметь наглость
injure: ушибить, повредить, ранить; обижать
forehead: лоб; передняя часть
pave: мостить, выстилать; устилать
straight: прямая линия; прямизна
pail: ведро; бадья
peg: вешалка; крючок; колышек; прибивать гвоздями
fade: выгорать, выцветать, линять; вянуть, увядать
tie: связывать, привязывать; лента, шнур; узел, петля
worn: изношенный; усталый, изнурённый
leather: кожа; кожаные изделия; ремень
brisk: оживлённый; проворный
tinkle: звенеть; звякать; звенящий звук
whisk: смахивать; сгонять; быстро уносить; метёлочка
neat: чистый, чистоплотный; опрятный, аккуратный
dainty: лакомство, деликатес; изящный, грациозный
abundance: изобилие, избыток; множество
hearty: обильный, плотный (о еде); сердечный; здоровый
frock: женское или детское платье; ряса
pull: тянуть, тащить
grave: серьёзный, веский, важный; могила
pleasant: приятный; милый, славный; симпатичный
resolve: решать, принимать решение
lean: худой, тощий; наклоняться, нагибаться; прислонять
chin: подбородок
husky: сиплый, хриплый; сухой, шероховатый; детина; здоровяк
tedious: скучный; утомительный
stretch: вытягивание, растягивание
awful: ужасный, отвратительный; очень, весьма
suspect: подозревать, предполагать, не доверять; подозрительный
