abide abode abode : пребывать, терпеть, соблюдать
be was been : быть
bear bore born : нести, рожать
beat beat beaten : бить
become became become : становится
begin began begun : начинать
bend bent bent : гнуть
bet bet bet : держать пари
bid bade bidden : предлагать цену
bite bit bitten : кусаться
bleed bled bled : кровоточить
blow blew blown : дуть
break broke broken : ломать
bring brought brought : приносить
build built built : строить
burn burnt burnt : гореть, жечь
burst burst burst : взрываться
buy bought bought : покупать
cast cast cast : бросать, проводить кастинг
catch caught caught : ловить
choose chose chosen : выбирать
come came come : приходить
cost cost cost : стоить
creep crept crept : ползти
cut cut cut : резать
dare durst dared : (по)сметь
deal dealt dealt : вести дела
dig dug dug : копать
do did done : делать
draw drew drawn : рисовать, тянуть 
drink drank drunk : пить
drive drove driven : водить автомобиль
dwell dwelt dwelt : обитать, останавливаться
eat ate eaten : есть
fall fell fallen : падать
feed fed fed : кормить
feel felt felt : чувствовать
fight fought fought : бороться
find found found : находить
flee fled fled : сбежать
fly flew flown : летать
forbid forbade forbidden : запрещать
forget forgot forgotten : забывать
forgive forgave forgiven : простить
freeze froze frozen : замораживать
get got got : получать
give gave given : давать
go went gone : идти
grind ground ground : точить, молоть
grow grew grown : расти
hang hung hung : висеть
have had had : иметь
hear heard heard : слышать
hide hid hidden : прятать
hit hit hit : попадать, ударять
hold held held : держать
hurt hurt hurt : причинять боль
keep kept kept : содержать, поддерживать
know knew known : знать
lay laid laid : класть, стелить
lead led led : вести, лидировать
learn learnt learnt : учиться, узнавать
leave left left : покидать, оставлять
lend lent lent : давать в займы
let let let : позволять
lie lay lain : лежать
light lit lit : зажигать, освещать
lose lost lost : терять
make made made : делать, мастерить
mean meant meant : значить
meet met met : встречать, знакомиться
mow mowed mown : косить
pay paid paid : платить
put put put : класть, ставить
read read read : читать
ride rode ridden : ездить верхом
ring rang rung : звонить
rise rose risen : восходить, подниматься
run ran run : бежать
say said said : сказать
see saw seen :видеть
seek sought sought : искать
sell sold sold : продавать
send sent sent : посылать
set set set : сажать, устанавливать
sew sewed sewn : шить
shake shook shaken : трясти
shed shed shed : проливать
shine shone shone : светить, сиять
shoot shot shot : стрелять
show showed shown : показывать
shrink shrank shrunk : сжиматься
shut shut shut : закрывать, затворять
sing sang sung : петь
sink sank sunk : погружаться, опускаться 
sit sat sat : сидеть
sleep slept slept : спать
slide slid slid : скользить
smell smelt smelt : пахнуть, нюхать
smite smote smitten : разбить, сразить
speak spoke spoken : говорить
speed sped sped : мчаться
spell spelt spelt : читать по буквам
spend spent spent : тратить, проводить
spill spilt spilt : разлить
spin spun spun : крутить, прясть
spit spat spat : плевать
split split split : разделять, раскалывать
spoil spoilt spoilt : портить
spread spread spread : развернуть, распространять
spring sprang sprung : прыгать, скакать
stand stood stood : стоять
steal stole stolen : воровать
stick stuck stuck : втыкать, прилепить
sting stung stung : жалить
stink stank stunk : вонять
strike struck struck : бастовать, ударять
string strung strung : нанизать, натянуть
swear swore sworn : клясться, ругаться
sweep swept swept : подметать
swim swam swum : плавать
swing swung swung : качать
take took taken : брать
teach taught taught : обучать
tear tore torn : рвать
tell told told : рассказывать
think thought thought : думать
throw threw thrown : бросать
thrust thrust thrust : толкнуть, сунуть
understand understood understood : понимать
upset upset upset : опрокинуть, расстроиться
wake woke woken : будить
wear wore worn : носить, одевать
weave wove woven : ткать
weep wept wept : плакать, запотевать
win won won : побеждать
wind wound wound : заводить часы, наматывать
write wrote written : писать
